1111111111
1000000001
1111110101
1000010101
1001010101
1001000011
1001111101
1000000001
1111111001
1000001101
1110000101
1000111101
1010000001
1$01111111
1111111111